************************************************************************
*______________________________________________________________________*
*|             |                |                |                |   |*
*|   |$               |                |                |       $     |*
*|   |---------|      |---------|      |---------|      |---------|   |*
*|        |                |                |                |        |*
*| |      |      |  |      |      |  |      |      |  |      |      | |*
*| |             |  |             |  |             |  |             | |*
*| | --|  |  |-- |  | --|  |  |-- |  | --|  |  |-- |  | --|  |  |-- | |*
*|     |  |  |          |  |  |          |  |  |          |  |  |     |*
*|     ---|---          ---|---          ---|---          ---|---     |*
*|                                                                    |*
*|     ---|---          ---|---          ---|---          ---|---     |*
*|     |  |  |          |  |  |          |  |  |          |  |  |     |*
*| | --|  |  |-- |  | --|  |  |-- |  | --|  |  |-- |  | --|  |  |-- | |*
*| |             |  |             |  |             |  |             | |*
*| |      |      |  |      |      |  |      |      |  |      |      | |*
*|        |                |                |                |        |*
*|   |---------|      |---------|      |---------|      |---------|   |*
*|   |$               |                |                |$            |*
*|             |                |                |                |   |*
*----------------------------------------------------------------------*
************************************************************************